NO ./sprites/n_wall.xpm
SO ./sprites/s_wall.xpm
WE ./sprites/w_wall.xpm
EA ./sprites/e_wall.xpm
C    225,30,0
F    220,100,0

111111111111111111111111111111111111111111111111111111111111111111111111111111
10000000000000000000000000000000000000000000000000000000N000000000000000000001
100000000000000000000000000000000000000000000000000000000011111111111111111111
1111011111111010011111111111111111101010101010111111111111
11110111111111111111111111111111111011110101011111111111111111111
10000000000000000000000000000000000000000000000000000000000000001
11111111111111111111111111111111111111111111111111111111111111111