NO ./sprites/n_wall.xpm
SO  ./sprites/s_wall.xpm
EA  ./sprites/e_wall.xpm
WE  ./sprites/w_wall.xpm
C    225,30,0
F    220,100,0

111111111111111111111111111111111111111111111111111111111111111111111111111111
10000000000000000000000000000000000000000000000000000000N000000000000000000001
10000000000000000000000000000000000000000000000000000000N000000000000000000001
10000000000000000000000000000000000000000000000000000000N000000000000000000001
10000000000000000000000000000000000000000000000000000000N000000000000000000001
100000000000000000000000000000000000000N0000000000000000N000000000000000000001
10000000000000000000000000000000000000000000000000000000N000000000000000000001
10000000000000000000000000000000000000000000000000000000N000000000000000000001
10000000000000000000000000000000000000000000000000000000N000000000000000000001
10000000000000000000000000000000000000000000000000000000N000000000000000000001
10000000000000000000000000000000000000000000000000000000N000000000000000000001
10000000000000000000000000000000000000000000000000000000N000000000000000000001
10000000000000000000000000000000000000000000000000000000N000000000000000000001
10000000000000000000000000000000000000000000000000000000N000000000000000000001
10000000000000000000000000000000000000000000000000000000N000000000000000000001
10000000000000000000000000000000000000000000000000000000N000000000000000000001
10000000000000000000000000000000000000000000000000000000N000000000000000000001
10000000000000000000000000000000000000000000000000000000N000000000000000000001
111111111111111111111111111111111111111111111111111111111111111111111111111111
